16,16
0000000000000000
S**0000****00000
00*0000*00*00000
00******00*00000
0000*00000*00000
0000*00000000000
00*****000000000
00*000*000000000
00*000*****00000
00*0000000**0000
00**000000000000
000******0000000
0000*000*0000000
00***000*0000000
00000000****F000
0000000000000000